species,type,A,T,C,G,N,total
ddis,intergenic,5352453,5350352,853709,853306,18488,12428308
ddis,ORF,7445880,7427550,2791727,2779729,19,20444905
ddis,miRNA,282,276,139,124,0,821
dfir,intergenic,9880152,9908422,3250962,3245412,4112629,30397577
dfir,ORF,0,0,0,0,0,0
dfir,miRNA,353,328,112,125,0,918
dfir_new,intergenic,11579860,11549767,3616958,3599152,0,30345737
dfir_new,ORF,0,0,0,0,0,0
dfir_new,miRNA,502,505,203,182,0,1392
dlac,intergenic,2254568,2259454,653349,658737,0,5826108
dlac,ORF,5939122,5901492,2810822,2803803,0,17455239
dlac,miRNA,81,90,37,34,0,242
ppal,intergenic,5201441,5201208,1609360,1604227,2000,13618236
ppal,ORF,5897242,5903892,3630634,3620334,0,19052102
ppal,miRNA,183,182,83,81,0,529
asub,intergenic,3695342,3698181,2226243,2233790,25841,11879397
asub,ORF,4917333,4931937,4600445,4613184,8,19062907
asub,miRNA,799,811,478,512,0,2600
dfas,intergenic,3817484,3815794,1492072,1487586,1000,10613936
dfas,ORF,6400871,6418584,3729217,3726879,0,20275551
dfas,miRNA,199,213,90,112,0,614
ppol,intergenic,54667290,54220750,38797166,39236314,15184544,202106064
ppol,ORF,0,0,0,0,0,0
ppol,miRNA,298,336,252,259,0,1145
acas,intergenic,4619247,4599866,5223188,5245788,0,19688089
acas,ORF,4338919,4370710,7402127,7410680,0,23522436
acas,miRNA,20,25,19,18,0,82
alen,intergenic,15688345,15663050,21927050,21996597,0,75275042
alen,ORF,0,0,0,0,0,0
alen,miRNA,120,109,131,137,0,497
